111111111111111
100000000000101
100010000100101
100000000100101
100000111111101
100000000000001
100000000000001
100000000000001
111111100000001
100100000000001
100100000000001
100000000000001
100000000000001
100000000000001
111111111111111